1111111111111
1000E00000001
1000001111001
111111C000001
1C00000000001
1000000000001
1C000000C0001
1000010000001
1000010000C01
1P0C010000001
1111111111111