1111111111111111111
10CC00000000C010001
1111101110110010001
110111C000000010001
1C00010000000010E01
1000111000000010001
1C000100C0000010001
10000100000000C0001
1000000000C00010001
1P0C010000000010001
1111111111111111111