11111111111111
10CC00000000C1
11111011101101
110111C0000001
1C000100000001
1000111000E001
1C000100C00001
10000100000001
1000000000C001
1P0C0100000001
11111111111111