1111111111111111111111111
10CC00000000C010000Z00001
11111Z11101100100C010C001
110111C000000010000100001
1C000100000Z0010E10111001
1000111000000011110001001
1C000100C000001Z000001001
10000100000000C0000100001
100Z000000C000100C010C001
1P0C010000000010000100001
1111111111111111111111111